60 61 62 63 64 65 66 10 10
70 71 72 73 74 75 76 10 10
80 81 82 83 84 85 86 10 10
90 91 92 93 94 95 96 10 10
10 10 10 24 25 25 25 25 28
00 00 00 36 35 35 35 37 38
00 00 01 00 00 11 11 67 68
00 00 00 11 12 11 14 14 00
00 00 00 21 22 22 23 00 00
00 00 01 31 31 31 33 00 00
00 00 00 00 00 00 00 00 00
00 00 00 00 00 00 00 00 00
00 00 00 00 00 00 00 00 00